NO textures/wall.xpm
SO textures/wall.xpm
WE textures/wall.xpm
EA textures/wall.xpm


F 220,100,8
C 225,30,4

11111111
10000001
1000E001
10000001
10100101
11111111