NO textures/wall_texture.jpg
SO textures/wall_texture.jpg
WE textures/wall_texture.jpg
EA textures/wall_texture.jpg

F 220,100,0
C 225,30,0

		111111111 1111111111111111
		100000001 1110000000000001
		101100001 1110000000000001
		100100001 1000000000000001
11111111101100001 1110000000000001
10000000001100001 1110111111111111
11110111111111011 100000010001
11110111111111011 101010010001
11000000110101011 100000010001
10000000000000001 100000010001
10000000000000001 101010010001
11000001110101011 111011110N0111
11110111 1110101  101111010001
11111111 1111111  111111111111